+++++++++++++++++++
+            +A +a+
+            ++ + +
+             0   +
+            ++++++
+                 +
+                 +
+                 +
+                 +
+                 +
+                 +
+                 +
+                 +
+++++++++++++++++++