++++++++++++++++++++++++
+   A                  +
+  AaA                 +
+   A          A   A A +
+                      +
+                  A   +
+             A        +
+                A  0  +
++++++++++++++++++++++++
