blue: 0,1,A
++++++++++++++++++++++++++++++++++++++++++++++++
+                   aA+0                       +
+ ++++++++++++++++++++++++++++++++++++++++++++ +
+                                              +
+ ++++++++++++++++++++++++++++++++++++++++++++++
+ +
+ +
+ +
+1+
+++