blue: 0,A
red: 1,C
++++++++++++++++++++++++
+c BBBBBBBBBBBBBBBBBB a+
+0                    1+
+A BBBBBBBBBBBBBBBBBB C+
++++++++++++++++++++++++
