blue: 0,A
red: 1,B
++++++++++                    +++++
+A0      ++++++++++++++++++++++  B+
+aaA                             1+
+baA     ++++++++++++++++++++++   +
++++++++++                    +++++
                     