blue: 0,1,2,3,4,5,6,7,A
+++++++++++++++++++++++++++++++
+A             0             1+
+ +++++++++++++ +++++++++++++ +
+ +           + +           + +
+ +           + +           + +
+ +           + +           + +
+ +           + +           + +
+ +           + +           + +
+ +++++++++++++ +++++++++++++ +
+2             3             4+
+ +++++++++++++ +++++++++++++ +
+ +           + +           + +
+ +           + +           + +
+ +           + +           + +
+ +           + +           + +
+ +           + +           + +
+ +++++++++++++ +++++++++++++ +
+5             6             7+
+++++++++++++++++++++++++++++++