blue: 0,A
red: 1,B
+++++                                   +++++
+   +++++++++++++++++++++++++++++++++++++  b+
+                                   A0      +
+0 B++++++++++++++++++a++++++++++++++++++   +
+++++                +++                +++++