blue:0,A
red: 1,B
+++++++++++++++++++++
+        0       1 b+
+ ++++++++++  +++++++
+A  B             a +
+++++++++++   +++++++
+                   +
+++++++++++++++++++++
