blue:0,A
red: 1,B
+++++++++++++++++++++++
+0B+++++++++++++++++A1+
+a                   b+
+  +++++++++++++++++  +
+++++++++++++++++++++++