+++++++++++++++++++
+0                +
+              ++++
+                 +
+              ++A+
+1              +a+
+++++++++++++++++++
