++++++++++++++++++
+      +     +   +
+      +  +  +   +
+0 A   + +a+ +   +
+ ++++ + + + + + +
+ ++++ + + + + + +
+ ++++   + +   + +
+ ++++++++ +++++ +
+                +
++++++++++++++++++