+++++++++++
+ C      c+
+0A      a+
+ B      b+
+++++++++++