blue: 0,A
red: 1,B
++++++++++                    +++++
+A0      ++++++++++++++++++++++  b+
+aaA                             1+
+baA     ++++++++++++++++++++++   +
++++++++++                    +++++
                     