+++++++++++++
+A0000000000+
+00000000000+
+00000000000+
+00000000000+
+00000000000+
+00000000000+
+00000000000+
+00000000000+
+00000000000+
+000000000 a+
+++++++++++++
