+++++++++++++++++++
+0A               +
+A             ++++
+    C      B    c+
+              ++b+
+1   B          +a+
+++++++++++++++++++
