+++++++++++++++++++
+0        A       +
+              ++++
+    C      B    c+
+              ++b+
+1   B          +a+
+++++++++++++++++++
