+++++++++++++++++++
+0               B+
+    ++++++++++++++
+ D  C          dc+
+              ++b+
+1   A          +a+
+++++++++++++++++++
