+++++++++++++++++++
+0               B+
+    ++++++++++++++
+    C           c+
+              ++b+
+    A          +a+
+++++++++++++++++++
