blue: 0,A
red: 1,B
+++++++++++++++
+A++       ++B+
+0    ba     1+
+             +
+++++++++++++++