blue: 0,A
red: B
+++++++++++++++
+A         B  +
+0      a     +
+       a   A +
+++++++++++++++