++++++++
+0  a  +
++ +   +
++A+   +
++++++++