++++++++
+0     +
+  A  a+
+      +
++++++++